WWWWWWWWWWWWWWWWWWWWWWWWWGGGGGGGGGGGGGGGGGGGGGGGGG
WWWWWWWWWWWWWWWWWWWWGGGGGGGGGGGGGGGGGGGGGGGGGGGGGG
WWWWWWWWWWWWWWWGGGGGGGGGGGGGGGGGGGGGGGGGGGGGGGGGGG
WWWWWWWWWWGGGGGGGGGGGGGGGGGGGGGGGGGGGGGGGGGGGGGGGG
WWWWWWWWWGGGGGGGGGGGGGGGGGGGGGGGGGGGGGGGGGGGGGGGGG
WWWWWWWWWWWGGGGGGGGGGGGGGGGGGSSSSSSSSSSGGGGGGGGGGG
WWWWWWWWWWGGGGGGGGGGGGSSSSSSSSSSSSSSGGGGGGGGGGGGGG
WWWWWWWWWWWGGGGGGGGGGGGGGGSSSSSSSSSSSSGGGGGGGGGGGG
WWWWWGGGGGGGGGGGGGGGGGGSSSSSSSSSSSSSSSSGGGGGGGGGGG
WWWWWGGGGGGGGGGGGGGGGSSSSSSSSSSSSSGGGGGGGGGGGGGGGG
WWWWWGGGGGGGGGGGGGGGGGGGGSSSGSSSSSSSGGGGGGGGGGGGGG
WWWWWGGGGGGGGGGRRRGGGGGGGGGGGGGGGGGGGGGGGGGGGGGRRR
WWWWWGGGGGGGRRRRGGGGGGGGGGGGGGGGGGGGGGGGGGGGGRRRRR
GGGGGGGGGGGGRRRRRGGGGGGGGGGGGGGGGGGGGGGGGGGGGGGRRR
GGGGRRRRGGGGGGGGGGGGGGGGGGGGGGGGGGGGGGGGGGGGGGGRRR
GGGGGGRRRRRRGGGGGGGGGGGGGGGGWWWWWWWWWGGGGGGGGGGGGG
GGGGGRRRRRRRGGGGGGGGGGGGGGWWWWWWWWWWWWGGGGGGGGGGGG
GGGGGGGGGGGGGGGGGGGGGGGGGGGWWWWWWWWWWWWWWGGGGGGGGG
GGGGGGGGGGGGGGRRRGGGGGGGGGGGGWWWWWWWWWWWGGGGGGGGGG
GGGGGGGGGGGRRRGGGGGGGGGGGGGGWWWWWWWWWWWWGGGGGGGGGG
GGGGGGGGGGGGGRRRRGGGGGGGGWWWWWWWWWWWGGGGGGGGGGGGGG
GGGGGGGGGGGGGGGGGGGGGGGGGGGGGGGGGGGGGGGGGGGGGGGGGG
GGGGGGGGGGGGGRRRGGGGGGGGGGGGGGGGGGGGGGGGGGGGGGGGGG
GGGGGGGGGGGGRRRRRRRGGGGGGGGGGGGGGGGGGGGGGGGGGGGGGG
GGGGGGGGGGGGGGGGGGGGGGGGGGGGGGGGGGGGGGGGGGGGGGGGGG


